"filename", "language", "Java", "comment", "blank", "total"
"c:\Users\muazzam\Desktop\ICS 3U Stuff\Culminating\ImageFolder.java", "Java", 30, 1, 10, 41
"c:\Users\muazzam\Desktop\ICS 3U Stuff\Culminating\Main.java", "Java", 5, 12, 5, 22
"c:\Users\muazzam\Desktop\ICS 3U Stuff\Culminating\gameEngine.java", "Java", 132, 1, 27, 160
"c:\Users\muazzam\Desktop\ICS 3U Stuff\Culminating\gameLogFolder.java", "Java", 113, 3, 21, 137
"c:\Users\muazzam\Desktop\ICS 3U Stuff\Culminating\gameLogScreen.java", "Java", 110, 9, 39, 158
"c:\Users\muazzam\Desktop\ICS 3U Stuff\Culminating\gamePlayScreen.java", "Java", 254, 17, 51, 322
"c:\Users\muazzam\Desktop\ICS 3U Stuff\Culminating\gamePlayScreen2.java", "Java", 163, 15, 51, 229
"c:\Users\muazzam\Desktop\ICS 3U Stuff\Culminating\gameSetupScreen.java", "Java", 132, 2, 32, 166
"c:\Users\muazzam\Desktop\ICS 3U Stuff\Culminating\titleScreen.java", "Java", 46, 1, 13, 60
"Total", "-", 985, 61, 249, 1295