"filename", "language", "Java", "comment", "blank", "total"
"c:\Users\muazzam\Desktop\ICS 3U Stuff\Culminating\ImageFolder.java", "Java", 1, 0, 0, 1
"c:\Users\muazzam\Desktop\ICS 3U Stuff\Culminating\QuickSortTest.java", "Java", 22, 1, 12, 35
"c:\Users\muazzam\Desktop\ICS 3U Stuff\Culminating\Stopwatch.java", "Java", 58, 0, 12, 70
"c:\Users\muazzam\Desktop\ICS 3U Stuff\Culminating\gameEngine.java", "Java", 10, 27, 2, 39
"c:\Users\muazzam\Desktop\ICS 3U Stuff\Culminating\gameEngineTest.java", "Java", 33, 0, 8, 41
"c:\Users\muazzam\Desktop\ICS 3U Stuff\Culminating\gameLogFolder.java", "Java", -4, 0, 0, -4
"c:\Users\muazzam\Desktop\ICS 3U Stuff\Culminating\gameLogScreen.java", "Java", 1, 1, -2, 0
"c:\Users\muazzam\Desktop\ICS 3U Stuff\Culminating\gamePlayScreen.java", "Java", 9, -1, 2, 10
"c:\Users\muazzam\Desktop\ICS 3U Stuff\Culminating\gameSetupScreen.java", "Java", 48, -1, 5, 52
"c:\Users\muazzam\Desktop\ICS 3U Stuff\Culminating\titleScreen.java", "Java", 35, 1, 9, 45
"Total", "-", 213, 28, 48, 289